91.merged.fq.assembled.fastq	glandulosa	gln
92.merged.fq.assembled.fastq	glandulosa	gln
93.merged.fq.assembled.fastq	glandulosa	gln
94.merged.fq.assembled.fastq	glandulosa	gln
37.merged.fq.assembled.fastq	glandulosa_subsp_adamsii	gln_ad
38.merged.fq.assembled.fastq	glandulosa_subsp_admsii	gln_ad
67.merged.fq.assembled.fastq	glandulosa_subsp_admsii	gln_ad
71.merged.fq.assembled.fastq	glandulosa_subsp_admsii	gln_ad
72.merged.fq.assembled.fastq	glandulosa_subsp_admsii	gln_ad
D3.merged.fq.assembled.fastq	glandulosa_subsp_admsii	gln_ad
D4.merged.fq.assembled.fastq	glandulosa_subsp_admsii	gln_ad
27.merged.fq.assembled.fastq	glandulosa_subsp_crassifolia	gln_cr
28.merged.fq.assembled.fastq	glandulosa_subsp_crassifolia	gln_cr
29.merged.fq.assembled.fastq	glandulosa_subsp_crassifolia	gln_cr
87.merged.fq.assembled.fastq	glandulosa_subsp_crassifolia	gln_cr
88.merged.fq.assembled.fastq	glandulosa_subsp_crassifolia	gln_cr
89.merged.fq.assembled.fastq	glandulosa_subsp_crassifolia	gln_cr
90.merged.fq.assembled.fastq	glandulosa_subsp_crassifolia	gln_cr
42683.merged.fq.assembled.fastq	glandulosa_subsp_crassifolia	gln_cr
42683_dupl.merged.fq.assembled.fastq	glandulosa_subsp_crassifolia	gln_cr
C1.merged.fq.assembled.fastq	glandulosa_subsp_crassifolia	gln_cr
C2.merged.fq.assembled.fastq	glandulosa_subsp_crassifolia	gln_cr
C3.merged.fq.assembled.fastq	glandulosa_subsp_crassifolia	gln_cr
C4.merged.fq.assembled.fastq	glandulosa_subsp_crassifolia	gln_cr
C5.merged.fq.assembled.fastq	glandulosa_subsp_crassifolia	gln_cr
1.merged.fq.assembled.fastq	glandulosa_subsp_cushingiana	gln_cu
2.merged.fq.assembled.fastq	glandulosa_subsp_cushingiana	gln_cu
B6.merged.fq.assembled.fastq	glandulosa_subsp_cushingiana	gln_cu
L5.merged.fq.assembled.fastq	glandulosa_subsp_cushingiana	gln_cu
L6.merged.fq.assembled.fastq	glandulosa_subsp_cushingiana	gln_cu
L7.merged.fq.assembled.fastq	glandulosa_subsp_cushingiana	gln_cu
L8.merged.fq.assembled.fastq	glandulosa_subsp_cushingiana	gln_cu
L9.merged.fq.assembled.fastq	glandulosa_subsp_cushingiana	gln_cu
N2.merged.fq.assembled.fastq	glandulosa_subsp_cushingiana	gln_cu
N3.merged.fq.assembled.fastq	glandulosa_subsp_cushingiana	gln_cu
N4.merged.fq.assembled.fastq	glandulosa_subsp_cushingiana	gln_cu
N5.merged.fq.assembled.fastq	glandulosa_subsp_cushingiana	gln_cu
N6.merged.fq.assembled.fastq	glandulosa_subsp_cushingiana	gln_cu
77.merged.fq.assembled.fastq	glandulosa_subsp_erecta	gln_er
78.merged.fq.assembled.fastq	glandulosa_subsp_erecta	gln_er
79.merged.fq.assembled.fastq	glandulosa_subsp_erecta	gln_er
32.merged.fq.assembled.fastq	glandulosa_subsp_gabrielensis	gln_gb
33.merged.fq.assembled.fastq	glandulosa_subsp_gabrielensis	gln_gb
34.merged.fq.assembled.fastq	glandulosa_subsp_gabrielensis	gln_gb
35.merged.fq.assembled.fastq	glandulosa_subsp_gabrielensis	gln_gb
MC4.merged.fq.assembled.fastq	glandulosa_subsp_gabrielensis	gln_gb
MC4_dupl.merged.fq.assembled.fastq	glandulosa_subsp_gabrielensis	gln_gb
G7.merged.fq.assembled.fastq	glandulosa_subsp_gabrielensis	gln_gb
G8.merged.fq.assembled.fastq	glandulosa_subsp_gabrielensis	gln_gb
G9.merged.fq.assembled.fastq	glandulosa_subsp_gabrielensis	gln_gb
H1.merged.fq.assembled.fastq	glandulosa_subsp_gabrielensis	gln_gb
H2.merged.fq.assembled.fastq	glandulosa_subsp_gabrielensis	gln_gb
4.merged.fq.assembled.fastq	glandulosa_subsp_glandulosa	gln_gl
6.merged.fq.assembled.fastq	glandulosa_subsp_glandulosa	gln_gl
17.merged.fq.assembled.fastq	glandulosa_subsp_glandulosa	gln_gl
18.merged.fq.assembled.fastq	glandulosa_subsp_glandulosa	gln_gl
19.merged.fq.assembled.fastq	glandulosa_subsp_glandulosa	gln_gl
20.merged.fq.assembled.fastq	glandulosa_subsp_glandulosa	gln_gl
21.merged.fq.assembled.fastq	glandulosa_subsp_glandulosa	gln_gl
22.merged.fq.assembled.fastq	glandulosa_subsp_glandulosa	gln_gl
24.merged.fq.assembled.fastq	glandulosa_subsp_glandulosa	gln_gl
25.merged.fq.assembled.fastq	glandulosa_subsp_glandulosa	gln_gl
26.merged.fq.assembled.fastq	glandulosa_subsp_glandulosa	gln_gl
44.merged.fq.assembled.fastq	glandulosa_subsp_glandulosa	gln_gl
45.merged.fq.assembled.fastq	glandulosa_subsp_glandulosa	gln_gl
46.merged.fq.assembled.fastq	glandulosa_subsp_glandulosa	gln_gl
47.merged.fq.assembled.fastq	glandulosa_subsp_glandulosa	gln_gl
48.merged.fq.assembled.fastq	glandulosa_subsp_glandulosa	gln_gl
49.merged.fq.assembled.fastq	glandulosa_subsp_glandulosa	gln_gl
50.merged.fq.assembled.fastq	glandulosa_subsp_glandulosa	gln_gl
51.merged.fq.assembled.fastq	glandulosa_subsp_glandulosa	gln_gl
52.merged.fq.assembled.fastq	glandulosa_subsp_glandulosa	gln_gl
53.merged.fq.assembled.fastq	glandulosa_subsp_glandulosa	gln_gl
54.merged.fq.assembled.fastq	glandulosa_subsp_glandulosa	gln_gl
55.merged.fq.assembled.fastq.merged.fq.assembled.fastq	glandulosa_subsp_glandulosa	gln_gl
56.merged.fq.assembled.fastq	glandulosa_subsp_glandulosa	gln_gl
57.merged.fq.assembled.fastq	glandulosa_subsp_glandulosa	gln_gl
58.merged.fq.assembled.fastq	glandulosa_subsp_glandulosa	gln_gl
59.merged.fq.assembled.fastq	glandulosa_subsp_glandulosa	gln_gl
60.merged.fq.assembled.fastq	glandulosa_subsp_glandulosa	gln_gl
61.merged.fq.assembled.fastq	glandulosa_subsp_glandulosa	gln_gl
PF7.merged.fq.assembled.fastq	glandulosa_subsp_glandulosa	gln_gl
42813.merged.fq.assembled.fastq	glandulosa_subsp_glandulosa	gln_gl
42813_dupl.merged.fq.assembled.fastq	glandulosa_subsp_glandulosa	gln_gl
B3.merged.fq.assembled.fastq	glandulosa_subsp_glandulosa	gln_gl
I3.merged.fq.assembled.fastq	glandulosa_subsp_glandulosa	gln_gl
I4.merged.fq.assembled.fastq	glandulosa_subsp_glandulosa	gln_gl
I5.merged.fq.assembled.fastq	glandulosa_subsp_glandulosa	gln_gl
I6.merged.fq.assembled.fastq	glandulosa_subsp_glandulosa	gln_gl
L1.merged.fq.assembled.fastq	glandulosa_subsp_glandulosa	gln_gl
L2.merged.fq.assembled.fastq	glandulosa_subsp_glandulosa	gln_gl
L3.merged.fq.assembled.fastq	glandulosa_subsp_glandulosa	gln_gl
L4.merged.fq.assembled.fastq	glandulosa_subsp_glandulosa	gln_gl
N8.merged.fq.assembled.fastq	glandulosa_subsp_glandulosa	gln_gl
O6.merged.fq.assembled.fastq	glandulosa_subsp_glandulosa	gln_gl
C6.merged.fq.assembled.fastq	glandulosa_subsp_glandulosa	gln_gl
C8.merged.fq.assembled.fastq	glandulosa_subsp_glandulosa	gln_gl
C9.merged.fq.assembled.fastq	glandulosa_subsp_glandulosa	gln_gl
D1.merged.fq.assembled.fastq	glandulosa_subsp_glandulosa	gln_gl
D2.merged.fq.assembled.fastq	glandulosa_subsp_glandulosa	gln_gl
8.merged.fq.assembled.fastq	glandulosa_subsp_leucophylla	gln_lu
9.merged.fq.assembled.fastq	glandulosa_subsp_leucophylla	gln_lu
10.merged.fq.assembled.fastq	glandulosa_subsp_leucophylla	gln_lu
11.merged.fq.assembled.fastq	glandulosa_subsp_leucophylla	gln_lu
12.merged.fq.assembled.fastq	glandulosa_subsp_leucophylla	gln_lu
13.merged.fq.assembled.fastq	glandulosa_subsp_leucophylla	gln_lu
14.merged.fq.assembled.fastq	glandulosa_subsp_leucophylla	gln_lu
30.merged.fq.assembled.fastq	glandulosa_subsp_leucophylla	gln_lu
31.merged.fq.assembled.fastq	glandulosa_subsp_leucophylla	gln_lu
36.merged.fq.assembled.fastq	glandulosa_subsp_leucophylla	gln_lu
39.merged.fq.assembled.fastq	glandulosa_subsp_leucophylla	gln_lu
40.merged.fq.assembled.fastq	glandulosa_subsp_leucophylla	gln_lu
41.merged.fq.assembled.fastq	glandulosa_subsp_leucophylla	gln_lu
42.merged.fq.assembled.fastq	glandulosa_subsp_leucophylla	gln_lu
43.merged.fq.assembled.fastq	glandulosa_subsp_leucophylla	gln_lu
62.merged.fq.assembled.fastq	glandulosa_subsp_leucophylla	gln_lu
63.merged.fq.assembled.fastq	glandulosa_subsp_leucophylla	gln_lu
64.merged.fq.assembled.fastq	glandulosa_subsp_leucophylla	gln_lu
65.merged.fq.assembled.fastq	glandulosa_subsp_leucophylla	gln_lu
66.merged.fq.assembled.fastq	glandulosa_subsp_leucophylla	gln_lu
68.merged.fq.assembled.fastq	glandulosa_subsp_leucophylla	gln_lu
69.merged.fq.assembled.fastq	glandulosa_subsp_leucophylla	gln_lu
70.merged.fq.assembled.fastq	glandulosa_subsp_leucophylla	gln_lu
73.merged.fq.assembled.fastq	glandulosa_subsp_leucophylla	gln_lu
74.merged.fq.assembled.fastq	glandulosa_subsp_leucophylla	gln_lu
Julian4.merged.fq.assembled.fastq	glandulosa_subsp_leucophylla	gln_lu
Julian4_dupl.merged.fq.assembled.fastq	glandulosa_subsp_leucophylla	gln_lu
B8.merged.fq.assembled.fastq	glandulosa_subsp_leucophylla	gln_lu
15.merged.fq.assembled.fastq	glandulosa_subsp_mollis	gln_ml
16.merged.fq.assembled.fastq	glandulosa_subsp_mollis	gln_ml
23.merged.fq.assembled.fastq	glandulosa_subsp_mollis	gln_ml
A1.merged.fq.assembled.fastq	glandulosa_subsp_mollis	gln_ml
A2.merged.fq.assembled.fastq	glandulosa_subsp_mollis	gln_ml
A3.merged.fq.assembled.fastq	glandulosa_subsp_mollis	gln_ml
A4.merged.fq.assembled.fastq	glandulosa_subsp_mollis	gln_ml
A5.merged.fq.assembled.fastq	glandulosa_subsp_mollis	gln_ml
A6.merged.fq.assembled.fastq	glandulosa_subsp_mollis	gln_ml
A7.merged.fq.assembled.fastq	glandulosa_subsp_mollis	gln_ml
A9.merged.fq.assembled.fastq	glandulosa_subsp_mollis	gln_ml
B1.merged.fq.assembled.fastq	glandulosa_subsp_mollis	gln_ml
B2.merged.fq.assembled.fastq	glandulosa_subsp_mollis	gln_ml
G1.merged.fq.assembled.fastq	glandulosa_subsp_mollis	gln_ml
G2.merged.fq.assembled.fastq	glandulosa_subsp_mollis	gln_ml
G3.merged.fq.assembled.fastq	glandulosa_subsp_mollis	gln_ml
G4.merged.fq.assembled.fastq	glandulosa_subsp_mollis	gln_ml
O3.merged.fq.assembled.fastq	otayensis?_glandulosa?	nd
